#########################
#                       #
#   X       X       X   #
#                       #
#   $       $       $   #
#                       #
#          @            #
#                       #
#########################